*****
*  s*
* ***
*   *
*E***
