*******
* *   *
* * * *
*   * *
* *** *
* *s  *
****E**
