*********
E       *
* ***** *
* *   * *
* * * * *
* * * * *
* * * * *
*   * *s*
*********
