*****************************************
* *   *   *   *   *   *   *   *     *   *
* * * * * * * * * * * * * * * * * * * * *
* * * * * * * * * * * * * * * * * * * * *
* * * * * * * * * * * * * * * * * * * * *
* * * * * * * * * * * * * * * * * * * * *
* * * * * * * * * * * * * * * * * * * * *
* * * * * * * * * * * * * * * * * * * * *
* * * * * * * * * * * * * * * * * * * * *
* * * * * * * * * * * * * * * * * * * * *
* * * * * * * * * * * * * * * * * * * * *
* * * * * * * * * * * * * * * * * * * * *
* * * * * * * * * * * * * * * * * * * * *
* * * * * * * * * * * * * * * * * * * * *
E * * * * * * * * * * * * * * * * * * * *
* * * * * * * * * * * * * * * * * * * * *
* * * * * * * * * * * * * * * * * * * * *
* * * * * * * * * * * * * * * * * * * * *
* * * * * * * * * * * * * * * * * * * * *
* * * * * * * * * * * * * * * * * * * * *
* * * * * * * * * * * * * * * * * * * * *
* * * * * * * * * * * * * * * * * * * * *
* * * * * * * * * * * * * * * * * * * * *
* * * * * * * * * * * * * * * * * * * * *
* * * * * * * * * * * * * * * * * * * * *
* * * * * * * * * * * * * * * * * * * * *
* * * * * * * * * * * * * * * * * * * * *
* * * * * * * * * * * * * * * * * * * * *
* * * * * * * * * * * * * * * * * * * * *
* * * * * * * * * * * * * * * * * * * * *
* * * * * * * * * * * * * * * * * * * * *
* * * * * * * * * * * * * * * * * * * * *
* * * * * * * * * * * * * * * * * * * * *
* * * * * * * * * * * * * * * * * * * * *
* * * * * * * * * * * * * * * * * * * * *
* * * * * * * * * * * * * * * * * * * * *
* * * * * * * * * * * * * * * * * * * * *
* * * * * * * * * * * * * * * * * * * * *
* * * * * * * * * * * * * * * * * * *** *
* * * * * * * * * * * * * * * * * *   * *
* * * * * * * * * * * * * * * * * *** * *
* * * * * * * * * * * * * * * * * *s* * *
* * * * * * * * * * * * * * * * * * * * *
* * * * * * * * * * * * * * * * * * * * *
* * * * * * * * * * * * * * * * * * * * *
* * * * * * * * * * * * * * * * * * * * *
* * * * * * * * * * * * * * * * * * * * *
*   *   *   *   *   *   *   *   *   *   *
*****************************************
