*E*****
*   * *
* * * *
*s* * *
*** * *
*     *
*******
